15
15
XXXXXXXXXXXXXXX
X    X  X     X
XXX XX XX XXXXX
X X
X XX XXXXXXXXXX
X    XX      XX
XXXX XX XXXX XX
X    XX XXX  XX
X XXXX    XX  X
X XXXXXXX XXX X
X         XX  X
XXXXXXXXXXXXX X
X        XX   X
X XX XX     XXX
XXXXXXXXXXXXXXX
